setupPlex	KEYWORD2
selectA	KEYWORD2
selectB	KEYWORD2
selectC	KEYWORD2
selectD	KEYWORD2
digitalReadA	KEYWORD2
digitalReadB	KEYWORD2
digitalReadC	KEYWORD2
digitalReadD	KEYWORD2
analogReadA	KEYWORD2
analogReadB	KEYWORD2
analogReadC	KEYWORD2
analogReadD	KEYWORD2
digitalWriteA	KEYWORD2
digitalWriteB	KEYWORD2
digitalWriteC	KEYWORD2
digitalWriteD	KEYWORD2

lcd_begin	KEYWORD2
lcd_init	KEYWORD2
lcd_clear	KEYWORD2
lcd_home	KEYWORD2
lcd_noDisplay	KEYWORD2
lcd_display	KEYWORD2
lcd_noBlink	KEYWORD2
lcd_blink	KEYWORD2
lcd_noCursor	KEYWORD2
lcd_cursor	KEYWORD2
lcd_scrollDisplayLeft	KEYWORD2
lcd_scrollDisplayRight	KEYWORD2
lcd_leftToRight	KEYWORD2
lcd_rightToLeft	KEYWORD2
lcd_autoscroll	KEYWORD2
lcd_noAutoscroll	KEYWORD2
lcd_setRowOffsets	KEYWORD2
lcd_createChar	KEYWORD2
lcd_setCursor	KEYWORD2
lcd_write	KEYWORD2
lcd_print	KEYWORD2
lcd_command	KEYWORD2
lcd_send	KEYWORD2
lcd_write4bits	KEYWORD2
lcd_write8bits	KEYWORD2
lcd_pulseEnable	KEYWORD2

PinA	LITERAL1
PinB	LITERAL1
SePinAA	LITERAL1
SePinAB	LITERAL1
SePinAC	LITERAL1
PinC	LITERAL1
PinD	LITERAL1
SePinBA	LITERAL1
SePinBB	LITERAL1
SePinBC	LITERAL1

LCD_CLEARDISPLAY	LITERAL1
LCD_RETURNHOME	LITERAL1
LCD_ENTRYMODESET	LITERAL1
LCD_DISPLAYCONTROL	LITERAL1
LCD_CURSORSHIFT	LITERAL1
LCD_FUNCTIONSET	LITERAL1
LCD_SETCGRAMADDR	LITERAL1
LCD_SETDDRAMADDR	LITERAL1
LCD_ENTRYRIGHT	LITERAL1
LCD_ENTRYLEFT	LITERAL1
LCD_ENTRYSHIFTINCREMENT	LITERAL1
LCD_ENTRYSHIFTDECREMENT	LITERAL1
LCD_DISPLAYON	LITERAL1
LCD_DISPLAYOFF	LITERAL1
LCD_CURSORON	LITERAL1
LCD_CURSOROFF	LITERAL1
LCD_BLINKON	LITERAL1
LCD_BLINKOFF	LITERAL1
LCD_DISPLAYMOVE	LITERAL1
LCD_CURSORMOVE	LITERAL1
LCD_MOVERIGHT	LITERAL1
LCD_MOVELEFT	LITERAL1
LCD_8BITMODE	LITERAL1
LCD_4BITMODE	LITERAL1
LCD_2LINE	LITERAL1
LCD_1LINE	LITERAL1
LCD_5x10DOTS	LITERAL1
LCD_5x8DOTS	LITERAL1

rs	LITERAL1
rw	LITERAL1
enable	LITERAL1
d0	LITERAL1
d1	LITERAL1
d2	LITERAL1
d3	LITERAL1
